1111111111111111111
1P01000001000000001
1101011101011111101
110C010101000000101
1111010101111110101
100001010000C100101
1011111011101100101
101C000000101C00101
1011011110101011101
1000010000101000101
1111110111101110101
100000C1000000C0001
1011111111111111101
100000000000000E001
1111111111111111111
