111111111111111
1P0C0C0C0C0C001
101010101010101
10C0C0C0C0C0C01
101010101010101
10C0C0C0C0C0C01
101010101010101
10C0C0C0C0C0C01
101010101010101
10C0C0C0C0C0E01
111111111111111
