1111111111111111111111111
1P00000000000000000000C01
1000000000000000000000001
100000C000000000000C00001
1000000000000000000000001
1000111111111111100000001
1000000000000000000000001
1000000000000000000000001
10001111110C11111000000C1
1000000000000000000000001
1C00000000000000000000E01
1111111111111111111111111
