1111111111111111111111111
1P000001100011111111100C1
1000001100001100001110001
1000011000011100001110001
1000110000000000001110001
1001111111100000001100001
1000000011100001111000001
1000000011100111111111001
1000000000000000000000001
1000000000000000000000001
1000000000000000000000001
100000000000C000000000001
1000000000000000000000001
1C000000000000000000000E1
1111111111111111111111111