11111
1P001
10C00
10E01
11111
