11111
1P001
11111
10C01
1E001
11111
